1,8,8,0,0,0,0
2,8,8,0,0,0,0
3,8,8,0,0,0,0
4,8,8,0,0,0,0
5,8,8,0,0,0,0